6
5
4 4 4 4 4 0
2 1 1 1 3 3
1 1 1 3 1 1
2 1 1 3 1 1
2 2 1 3 1 1